7;5
L;R;L;R;R
R;L;R;L;L
L;R;L;R;L
L;R;R;L;R
R;R;L;R;L
L;L;L;R;L
L;R;R;R;L
0,6
1,1
-
-
-
-
