7;7
L;R;L;R;R;R;L
R;L;R;R;L;L;L
L;R;L;R;L;R;L
R;R;R;R;R;L;R
L;L;L;R;L;L;R
R;R;R;L;L;L;R
L;R;L;R;L;R;L
0,6
6,0
2,1;2,2;5,2;4,4;3,5
-
2,0;5,2;2,4
-